NO ./sprites/walll.xpm
WE ./sprites/walll.xpm
EA ./sprites/walll.xpm
SO ./sprites/walll.xpm

M ./music/ghetto.mp3
S ./sprites/firetrash1.xpm
S2 ./sprites/firetrash2.xpm
F ./sprites/ggfloor.xpm
C ./sprites/sky.xpm

111111111111111111111111
100000000000000000000001
100200000000000002000001
100000000N00000000000001
100000000000000000000001
100000000000200002000001
100200000000000000000001
100000111110000101010001
100000100010000020000001
100000100010000100010001
100200100010000020000001
100000111110001010100001
100200000000200000000001
111111111111111111111111